111111111111111111111
1010000000000000000P1
1010000100000000000C1
1E1000000000000000001
111111111111111111111
