111111111111111
100000000000001
1C0000000000001
1P0E00000000001
1C0000000000001
1C0000000000001
111111111111111
