11111111111111111111111111111111
10011110000000010010010000100001
10100000000000010000000000010001
10000000000000101010001000000101
10000000011011000001100010000001
11011001000000000000000000000001
10000011000001000000001000000001
10101000000010100100000000000001
1000000100110010000001000000P011
10101000100000100000000000000001
10000010001000000000010100000001
10000001000000000000000000000001
10010000000C01011001000000000001
10000010000100000000000000010001
10000100001001000000000010000101
10010010100100001100000000100001
11000000000000000000010010000001
10001010011100000000000000000001
11001000000100000000001000000101
10100110000100000001001000000001
11000000010000010010000000000011
10000001110C000000100000001E0001
11111111111111111111111111111111
